==================================================
                   ====================          =
=============== === = = ======  == ====== ========
========                                     ==  =
=====    ============   ======================  ==
===   =     ========                    == =======
==   ==     ==  =========  =========== ===  ==== =
=   ===  =  ==  =  =          ======     =  = =  =
=   ===  =  ======= === ===== ========   =========
==  === =                  ===  =====         ====
= = ===  =   ============    ================    =
= =    =====   ==  ==   ====  =   =========== ====
= ==   =====  =====      ==  = = ===  ======   ===
= === === ===       ===        ===  ======== =====
= ====== ====   ==========  ===     ===      =====
= ========         = ======= =    == ==  =========
=     =  =  ====   == = ===  = =========    ======
================  ====== =====  ========== =======
= =====                   =         ==           8
==================================================
