==================================================
                   ====================          =
=============== ========================= ========
========              =========================  =
=====    ============   ======================  ==
===   =     ========                     = =======
==   ==     ==  =========  =========== ===  ==== =
=   ===  =  ==  =  =        ========     =  = =  =
=   ===  =  ======================================
==  === =                  ===  =====      =======
=== ===  =   ============    =================== =
===    =====   =============  =   =========== ====
============  ======================  ======   ===
=============       ===        ===  ======== =====
==========================  ========== ===   =====
==========         = ======= =    == ==  =========
=     =  =  ====   ========  = =========    ======
================  ============  ========== =======
= =====                   =         ==           8
==================================================
